1111111111111
1001000011011
1P0010E00C111
1111111111111
