1111111111111111
110C110101001011
10001101P0E00101
1111111111111111
